wwwwwwwwwwwwwwwwwwwwwwwwwwww
+++wgw++++++++++++++++++++++
00==00==00==00==00==00==00==
=0=0=0=0=0=0=0=0=0=0=0=0=0=0
0==00==00==00==00==00==00==0
wwww++++wwww++++wwww++++wwww
xxxx....xxxx....xxxx....xxxx
....____....____....____....
.x.x.x.x.x.x.x.x.x.x.x.x.x.x
wA+++++++++++++++++++++++++w
wwwwwwwwwwwwwwwwwwwwwwwwwwww
