LevelMapping
    0 > background base 
    A > background avatar 
    1 > background portalSlow 
    2 > background portalFast 
    w > wall 
    . > background 

LevelDescription
1.............................
000...........................
000........................000
...........................0..
......0000...0000000..........
......0..0..00000..0..........
............0.................
..............................
000000.........00..00.........
....00.........00..00.........
..A...........................
