wwwwwwwwwwwww
w+.........gw
w...........w
w....1.2....w
w.....A.....w
w....3.1....w
w...........w
w...........w
wwwwwwwwwwwww
