wwwwwwwwwwwww
w+..........w
w..........gw
w...........w
w.1.2.3.1.2.w
w...........w
wA..........w
w...........w
wwwwwwwwwwwww
