1.2...........................
000...........................
..............................
..............................
..............................
...000......000......000......
...000......000......000......
..............................
..............................
.......0000000000000..........
................A.............